konyol : bodoh
utk : untuk
ghost buster : pemburu hantu
dgn : dengan
curiosity : rasa ingin tahu
indigenous : kekebalan
immunity : kekebalan
rs : rumah sakit
policy maker : pembuat kebijakan
menfasilitasi : memfasilitasi
menkes : menteri kesehatan
menristek : menteri negara riset dan teknologi
benak : ingatan
sobat : sahabat
jatim : jawa timur
s.d. : sampai dengan
ri : republik indonesia
wna : warga negara asing
wni : warga negara indonesia
disumbang : sumbang
penyumbang : sumbang
prokes : protokol kesehatan
spesimen : jenis
herd : kelompok
hipmi : himpunan pengusaha muda indonesia
klaim : aduan
update : baru
tdk : tidak
blh : boleh
mevaksin : memvaksin
jd : jadi
scr : secara
dg : dengan
dgn : dengan
test : tes
krn : karena
msh : masih
org : orang
tp : tapi
byk : banyak
udh : udah
yg : yang
pd : pada
knapa : kenapa
knp : kenapa
atlit : atlet
pdahal : padahal
terkonfirnasi : terkonfirmasi
satgas : satuan gagasan
jubir : juru bicara
pemprov : pemerintah provinsi
varian : jenis
sekjen : sekretaris jendral
kemenkes : kementrian kesehatan
wamenkes : wakil menteri kesehatan
bnyak : banyak
bgt : banget
sdh : sudah
cOoid-19 : covid 19
km : kamu
smoga : semoga
dpt : dapat
cuan : uang
vaccine : vaksin
jd : jadi
vaccin : vaksin
kl : kalau
niy : nih
utk : untuk